R 500 500

NO ./textures/brick.xpm
SO ./textures/blue.xpm
WE ./textures/wood.xpm
EA ./textures/grey.xpm

S ./textures/barrel.xpm
F 40,50,20
C 40,160,255
                    1111111111111111111111111
111111111111111111111000000000000000000000001
100000000000000000000000111111111111111111111
100000000000N000000000001
1000000000000000000000001
1000000000000000000000001
1 1 1 1 1 1 1 1 1 1 1 1 1
