R 400 200

NO ./textures/brick.xpm
SO ./textures/blue.xpm
WE ./textures/wood.xpm
EA ./textures/grey.xpm

S ./textures/chest.xpm
F 224,172,105
C 205,249,255

111111111111
100000000001
100000000001
100000000001
10000E000001
100000000001
100000000001
100000000001
111111111111
