R  1080 720

NO ./textures/wall.xpm
SO ./textures/doom.xpm
WE ./textures/mur.xpm
EA ./textures/eagle.xpm


S ./textures/chalice.xpm
F 224,172,105
C 205,249,255

111111111111111111111111111111111
100000000000000000000000000000001
100000000000000000000000000000001
100000000000000000000000000000001
100000000000000000000000000000001
100000000000000000000000000000001
100000000000000000000000000000001
100000000000000000000000000000001
100000000000000000000000000000001
100000000000000000000000000000001
100000000000000000000000000000001
100000000000000000000000000000001
100000000000000000000000000000001
1000000000000000N0000000000000001
111111111111111111111111111111111
