R 1000 1000

NO ./textures/wall.xpm
SO ./textures/doom.xpm
WE ./textures/mur.xpm
EA ./textures/eagle.xpm

S ./textures/barrel.xpm
F 40,50,20
C 40,160,255

11111111111111111111111111111111111111111111111111111111111111111111111111111111111111111111111111
10000000000000000000000000000000000000000000000010000000000000000000000000000110000000000000000001
10000000000000000000000000000000000000000000000010000000000000000000000000000100000000000000000001
10000000000000000000000000000000000000000000000010000000000000000000000011111100000000000000000001
10000000000000000000000000000000000000000000000010000000000000000000000000000110000000000000000001
10000000000000000000000000001000000000000000000010000000000000000000000000000100000000000000000001
10000000000000000000000000001000000000000001111111111111111111000000000000000100000000000000000001
10000000000000000000000000001000000000000000000000000000000000000000000000000100000000000000000001
10000000000000000000000000001000000000000000000000000000000000000000000000000100000000000000000001
10000000000000000000000000001111111111111000000000000000011111111111111111000100000000000000000001
10000000000011111111111111110000000000001000000000000000000000000000000001000000000000000000000001
10000000000000000000000000000000000000001000000000000000000011111111111101100111111000000000000001
10000000000000000000000000000000000000001000000000000000000000000000000101000100000000000000000001
10000000000000000000000000000000000000001000000000000000000000000111111101000100000000000000000001
10000000000000000000000000000000000000001000000000000000000000000100000000000100000000000000000001
10000000000000000000000000000000000100001111111111111111100000000100000000000100000000000000000001
10000000000111111111111111111111111100000000000000000000100000000100000000000100000000000000000001
100000000000000000000000000000000001000000000000W0000000100000000100000000000100000000000000000001
10000000000000000000000000000000000100000000000000000000111111111100001111111110000000000000000001
10000000000010000000000000000000000100000000000000000000000000000000001000000000000000000000000001
10000000000000000000000000000000000100000000000000000000100000000000011000000000000000000000000001
10000000000000000000000000000000001100000000000000000000100000000000001000000000000000000000000001
10000000000000100000000000100000100100000000001111111111100000000000001000000000000000000000000001
10000000000000000000000000000000000110000000000000000000000000000000001000000000000000000000000001
10000000000000000000000000000000000100000000000000000000000000000000001000000000000000000000000001
10000000000000000000000100000000000000000000111111111111111111110000001000000000000000000000000001
10000000000000000000001000000000000000000000000000000000000000000000001000000000000000000000000001
10000000000000010000000000000000000000000000000000000000000000000000001000000000000000000000000001
10000000000000000000001000000000000000000000000000000000000000000000000000000000000100000000000001
10000000000000000000000000000000000000000000000000000000000000000000000000000000000100000000000001
10000000000000000000000000000000000000000000000000000000000000000000000000000000000100000000000001
10000000000000000000000000000000000000000000000000000000000000000000000000000000000100000000000001
11111111111111111111111111111111111111111111111111111111111111111111111111111111111111111111111111

