R 600 600

NO ./textures/wall.xpm
SO ./textures/doom.xpm
WE ./textures/mur.xpm
EA ./textures/eagle.xpm

S ./textures/barrel.xpm
F 150,150,150
C 40,160,255

111111111111111111111111111111
100000000000000000010000000001
100000000000000000010000000001
100000000000000000010000000001
100000000000000000000000000001
10000000000000N000000000000001
100000000000000000000000000001
100000000000000000000000000001
100000000000000000000000000001
100000000000000000000000000001
111111111111111111111111111111
