R 1600 1600

NO ./textures/doom.xpm
SO ./textures/wood.xpm
WE ./textures/wall.xpm
EA ./textures/eagle.xpm

S ./textures/barrel.xpm
F 150,150,150
C 40,160,255

111111111111111111111111111111
100000000000000000000000000001
100000000000000000000000000001
100000000000000000000000000001
100000000000000000000000000001
10000000000000N000000000000011
100000000000000000000000000001
100000000000000000000000000001
100000000000000000000000000001
100000000000000000000000000001
111111111111111111111111111111
